168 169 3
170 169 1
169 170 1
171 170 3
169 172 1
169 173 2
172 173 1
174 173 1
169 174 1
170 175 1
169 176 1
175 176 1
175 177 1
169 177 1
